#############################
S....#......................#
#.##.#.#.######.#.#.#######.#
#.#..#.#.#....#.#.#.......#.#
#.#.##.#.#.##.#.#.#######.#.#
#.#....#.#..#.#.#.#.....#...#
#.######.##.#.#.#.#.###.#.###
#......#....#.#.#.#...#.#.#.#
#.####.######.#.#.###.#.#.#.#
#.#..#........#.#.#...#.#...#
#.#.###########.#.#.###.###.#
#.#.............#.#.....#.#.#
#.###############.#####.#.#.#
#.................#.....#.#.G
#############################