####################################
S..................................#
#.################################.#
#.#..............................#.#
#.#.############################.#.#
#.#.#..........................#.#.#
#.#.#.########################.#.#.#
#.#.#.#......................#.#.#.#
#.#.#.#.####################.#.#.#.#
#.#.#.#.#..................#.#.#.#.#
#.#.#.#.#.################.#.#.#.#
#.#.#.#.#.#..............#.#.#.#.#
#.#.#.#.#.#.############.#.#.#.#.#
#.#.#.#.#.#.#..........#.#.#.#.#.#
#.#.#.#.#.#.#.########.#.#.#.#.#.#
#.#.#.#.#.#.#.#......#.#.#.#.#.#.#
#.#.#.#.#.#.#.#.####.#.#.#.#.#.#.#
#.#.#.#.#.#.#.#.#..#.#.#.#.#.#.#.#
#.#.#.#.#.#.#.#.#..#.#.#.#.#.#.#.#
#.#.#.#.#.#.#.#.####.#.#.#.#.#.#.#
#.#.#.#.#.#.#.#......#.#.#.#.#.#.#
#.#.#.#.#.#.#.########.#.#.#.#.#.#
#.#.#.#.#.#.#..........#.#.#.#.#.#
#.#.#.#.#.#.############.#.#.#.#.#
#.#.#.#.#.#..................#.#.#
#.#.#.#.#.####################.#.#
#.#.#.#.#......................#.#
#.#.#.#.########################.#
#.#.#.#..........................#.#
#.#.#.############################.#
#.#.#..............................#.#
#.#.##############################.#
#.#................................#.#
#.##################################.#
#..................................#.G
####################################

