########################
S......................#
#......................#
#......................#
#......................#
#......................#
#......................#
#......................#
#......................#
#......................#
#......................#
#......................#
#......................#
#......................#
#......................#
#......................#
#......................#
#......................#
#......................#
#......................#
#......................G
########################

