##########
S........#
#.#######.#
#.#.......#
#.#.#######
#.#........
#.#########
#..........G
##########

