####################
S...................#
#.##################.#
#.#..................#.#
#.#.################.#.#
#.#.#..............#.#.#
#.#.#.############.#.#.#
#.#.#.#..........#.#.#.#
#.#.#.#.########.#.#.#.#
#.#.#.#.#......#.#.#.#.#
#.#.#.#.#.####.#.#.#.#.#
#.#.#.#.#.#..#.#.#.#.#.#
#.#.#.#.#.####.#.#.#.#.#
#.#.#.#.#......#.#.#.#.#
#.#.#.#.########.#.#.#.#
#.#.#.#..........#.#.#.#
#.#.#.############.#.#.#
#.#.#..............#.#.#
#.#.################.#.#
#.#..................#.#
#.##################.#
#...................G
####################

